10 :: 10
104 104 104 104 104 104 104 104 104 104
104 104 104 104 104 102 102 102 102 104
104 104 104 104 104 104 102 104 104 104
104 104 104 104 102 102 102 102 102 104
104 104 104 102 102 102 102 101 101 104
102 102 102 102 102 102 103 103 103 103
104 104 102 102 102 102 102 103 101 104
104 104 104 104 102 102 102 104 104 104
104 104 104 104 104 104 104 104 104 104
104 104 104 104 104 104 104 104 104 104