10 :: 10
104 104 104 104 104 104 104 104 104 104
104 104 102 102 102 102 104 104 104 104
104 102 102 102 101 102 102 104 104 104
104 104 102 102 102 102 102 102 102 104
104 104 102 102 101 102 101 102 104 104
102 102 102 102 102 102 102 102 102 102
104 102 102 102 102 102 102 102 104 104
104 104 104 102 102 102 101 102 102 104
104 102 102 102 102 102 102 102 104 104
104 104 104 104 104 104 104 104 104 104